##########################
#%.....%%%%.....%%%%.....#
#%..#..%%%%.....%%%%.....#
#%.....%%%%.....%%%%.....#
#%%%%%%%%%%%%%%%%%%%%%%%%#
#%%%%%%%%%%%%%%%%%%%%%%%%#
#%.....%%%%.....%%%%.....#
#%.....%%%%.....%%%%.....#
#%.....%%%%.....%%%%.....#
##########################