##########################
#%.....%%%%.....%%%%.....#
#%..#..%%%%.....%%%%.....#
#%..#..%%%%.....%%%%.....#
#%%%#%%%%%%%%%%%%%%%%%%%%#
#%%%#%%%%########%%%%%%%%#
#%..#..%##%.###.#%%%.....#
#%..####%%#.....%%%%.....#
#%.....%%%#####.%%%%.....#
####...####.#..######.####
#%.....%##%#####..#%.....#
#%..####%%#.....%%%%.....#
#%..........##.%%##.....%#
#%..#..%##%.....#%%%.....#
#%......%#........%......#
#%.....%%%#####.%%%%.....#
#####..................###
#######......#############
#%.....%%%%.....%%%%.....#
#%..#..%%%%.....%%%%.....#
#%..#..%%%%.....%%%%.....#
#%%%#%%%%%%%.....%%%%%%%%#
#%%%#%%......####%%%%%%%%#
#%..........###.#%%%.....#
#%.......................#
#%..............%%%%.....#
####...####.#..######.####
#%.....%##%#####..#%.....#
#%..####%%#.....%%%%.....#
#%......................%#
#%..#..%##%..............#
#%......%#........%......#
#%.....%%%###............#
##########################