##########################
#%.....%%%%.....%%%%.....#
#%..#..%%%%.....%%%%.....#
#%..#..%%%%.....%%%%.....#
#%%%#%%%%%%%%%%%%%%%%%%%%#
#%%%#%%%%########%%%%%%%%#
#%..#..%##%.###.#%%%.....#
#%..####%%#.....%%%%.....#
#%.....%%%#####.%%%%.....#
####...####.#..######.####
#%.....%##%#####..#%.....#
#%..####%%#.....%%%%.....#
#%..........##.%%##.....%#
#%..#..%##%.....#%%%.....#
#%......%#........%......#
#%.....%%%#####.%%%%.....#
##########################