##########################
#%.....%%%%.....%%%%.....#
#%..#..%%%%.....%%%%.....#
#%..#..%%%%.....%%%%.....#
#%%%#%%%%%%%%%%%%%%%%%%%%#
#%%%#%%%%########%%%%%%%%#
#%..#..%##%.....#%%%.....#
#%..####%%#.....%%%%.....#
#%.....%%%#####.%%%%.....#
##########################