####################################################
#%.....%%%%.....%%%%.....##%.....%%%%.....%%%%.....#
#%..#..%%%%.....%%%%.....##%..#..%%%%.....%%%%.....#
#%..#..%%%%.....%%%%.......%..#..%%%%.....%%%%.....#
#%%%#%%%%%%%%%%%%%%%%%%%%..%%%#%%%%%%%%%%%%%%%%%%%%#
#%%%#%%%%########%%%%%%%%..%%%#%%%%%%%%%%%%%%%%%%%%#
#%..#..%##%.###.#%%%.....##%%%#%%%%%%%%%%%%%%%%%%%%#
#%..####%%#.....%%%%.....##%%%#%%%%%%%%%%%%%%%%%%%%#
#%.....%%%#####.%%%%.....##%.....%%%#####.%%%%.....#
####...####.#..######.#####%%%#%%%%%%%%%%%%%%%%%%%%#
#%.....%##%#####..#%.....##%..............%%%%.....#
#%..####%%#.....%%%%.......%.....%%%#####.%%%%.....#
#%..........##.%%##.....%##%..............%%%%.....#
#%..#..%##%.....#%%%.....##%.....%%%#####.%%%%.....#
#%......%#........%........%%%#%%%%%%%%%%%%%%%%%%%%#
#%.....%%%#####.%%%%.....##%.....%%%#####.%%%%.....#
#####..................####%%%#%%%%%%%%%%%%%%%%%%%%#
#######......####################......#############
#%.....%%%%.....%%%%.....##%%%#%%%%%%%%%%%%%%%%%%%%#
#%..#..%%%%.....%%%%.....##%..............%%%%.....#
#%..#..%%%%.....%%%%.....########......#############
#%%%#%%%%%%%.....%%%%%%%%##%%%#%%%%%%%%%%%%%%%%%%%%#
#%%%#%%......####%%%%%%%%..######......#############
#%..........###.#%%%.....##%.....%%%###............#
#%.........................%.....%%%###............#
#%..............%%%%.....##%.....%%%###............#
####...####.#..######.#####%.....%%%###............#
#%.....%##%#####..#%.....##%..............%%%%.....#
#%..####%%#.....%%%%.....##%%%#%%%%%%%%%%%%%%%%%%%%#
#%......................%##%..............%%%%.....#
#%..#..%##%..............##%%%#%%%%%%%%%%%%%%%%%%%%#
#%......%#........%......##%..............%%%%.....#
#%.....%%%###............##%..............%%%%.....#
####################################################